+b++++++++++++++++++++++++++++++++++++++++++++++++
+    ++ +         + + + +   ++   + ++     + + ++ +
++ +++  ++ ++++++++     ++ ++  +++ ++ + +++   ++ +
+    ++ ++  + ++  +++ +++   + +++     +++ + +++  +
+++ ++   + ++ ++ ++ + + +++ + +   +++++++    ++ ++
+   ++ +++    ++ ++ + + ++      + +++     + +++  +
++ +++ + ++ +++  ++ +    ++ ++ ++++ ++ +++++++  ++
++ + + +     +  +++   +++++  + + ++  + + ++  ++ ++
+  + + + +++++ ++ + ++++    ++++  ++ + +  ++  +  +
++   + + ++ +  ++      ++++ + ++ +++ + + +++ ++ ++
++++ + + ++ + +++ ++++++      +    + + + + + ++  +
+ ++ +    +   ++  + ++ ++++ +++ ++++ +          ++
+ ++ +++ ++ +++++ +  + ++ + ++       + +++++ + +++
+ ++ ++  ++  ++   + ++ ++ +    + + + + +++++++ +++
+ ++  ++ ++ ++  +++ +  +    ++ +++++ +       +  ++
+ +++ +   + ++ ++ +   ++ +++++   +++++ ++++ +++  +
+ + + ++ ++  + ++   +++      +++++ ++     +   ++ +
+           ++    +++++ ++++++++ + +++ ++++ +++  +
++ ++++ ++++++ +++++  +   ++ + + + + +   ++++ ++++
++++  + +  + +       ++ +++            +++ ++    +
+ +++     ++ + ++++++++ ++++ +++++++ +   + ++ ++++
+ + ++ +++++   ++ + + +   +      +++++++    +    +
+   ++   ++  +++      + +++ ++++++  +  ++++++ ++++
+++ ++ +++++     + + ++ + +  + + ++   ++  + +  + +
+    + +++ + ++++++++++ + + ++ + ++ +++++     ++ +
+++ ++   +   +  + + ++           ++  + +  +++++  +
+      +++ +++ ++ + +  + +++++++ ++ ++   +++    ++
++++++  ++  +   + +   +++++ ++ +++  +  + + + +++++
++ + ++  ++ + +++   +  +++  +    ++   ++++ +     +
+     + ++        ++++++ ++ + ++++  +++ +  + +++++
+ ++ ++ ++ ++++++++ +++   +    + + ++ + + ++   + +
+ +   + +     ++ +    ++ ++ ++++             +++ +
+++++ +   +++++    +++++    + ++ +++++ + +++     +
+  ++   +     + ++   + + ++          + +   ++ + ++
++ ++ ++++ ++++ ++++ +    ++ + ++ + ++ + +++++++++
+       +++++     ++++ ++++++++++ +  +++       + +
+++++ +   + ++ ++++ ++   ++ + + +++ ++   ++ ++++ +
+++   + +      +       +  +      ++  +++  +    + +
+   + +++ + + ++ +++ + ++   ++++++++++++++++++++ +
+ + +  ++ + ++++   + +  +++      + +++   + +  ++ +
+ + ++  + +      +++++ ++++ ++++++   ++ ++ + ++  +
+ + ++ ++ ++ + +     + +       + + +++  +     ++ +
+ + ++  + +  +++ ++++++++ + ++     + ++ + ++++++ +
+++  ++ ++++   +++++ +++  + ++ + +    + + +      +
++  ++   + + +++++   + + ++ ++ + ++ +       ++++++
+  ++  +   +       +++ ++++ ++ + ++ ++ + ++  +   +
++  ++ + +++ ++ ++++++    +++  +++   + +++++ + +++
+++ ++++ +++++         + +++++   ++ ++    ++     +
+   +        ++ + ++ + +    ++ +  +  ++ + +  + + +
++++++++++++++++++++++++++++++++++++++++++++++++p+